############################################
#
#
#
#                   #####
#            ######
#    ######
#
#############################################