



        0

      #######
     ###########
   ###############
  ###########################################
#################################################