
         0


               @@@@@

      ######
      ######
      ######
      ######
################## ##############################