






                    ####
     0              ####
                    ####           ####
       ##@@@##@@#   ####           ####
                    ####           ####
   ##############   ####       ########
##########################  ###########