






                    ####
     0              ####
       ##@@@##@@#   ####           ####
       ##           ####           ####
                    ####           ####
   ##############   ####       ########
##########################  ###########