T          [N]
!
!            T
!   [N]      !
!       []   !
####D       G#
@@@@@#######@@
