







         0


               @@@@@

      ######
      ######
      ######
      ######
#################  ##############################