










     0
                    ####           ####
         @@@@@@@@   ####           ####
                    ####           ####
   ##############   ####       ########
##########################  ###########