##          #
#           #
#     #     #
#           #
#############
