


NNNNNNNNNNN]                           []

                 [NNNNNNNNNNNNNNNNN]
T          [N]
!                  T  [N]          T
!        [NNNNNN]  !       []      !
!   [N]            !           []  !
!       []   G######D              !
####D       G#@@@##@@###D         G#
@@@@########@@@@@@@@@@@@@#########@@
@@@@@@@@@@@@@@@@@@@@@@@@@@@@@@@@@@@@
@@@@@@@@@@@@@@@@@@@@@@@@@@@@@@@@@@@@
@@@@@@@@@@@@@@@@@@@@@@@@@@@@@@@@@@@@
@@@@@@@@@@@@@@@@@@@@@@@@@@@@@@@@@@@@