






                    ####
     0              ####
       ##@@@##@@#   ####           ####
                    ####           ####
                    ####           ####
   ##############   ####       ########
##########################  ###########