






                |   ####
     0          |   ####
       @@@@@@@@@|   ####           ####
       @@       |   ####           ####
                    ####           ####
   ##############   ####       ########
##########################  ###########