##          #
#           #
#           #
#           #
#############
