
          |                                                                          |
          |                                                                          |
       0  |                                                                          |
@@@@@     |                                                                          |
          |                                                                          |
          |           |     |####                                                    |
    @@@@@@|           |     |####                                                    |
                      |     |####                                                    |
             @@@@@@   |     |####          ####            ###         ##            |
     @                |     |####          ####          #####         ####          |
                             ####          ####        #######         ######       S|
              ###  ################    ########      ##########################     S|
#################  ##################################################################|