                                                                     
          |                                                                 |
          |                                                                 |
       0  |                                                                 |
@@@@@     |                                                                 |
          |                                                                 |
          |           |     |####                                           |
    @@@@@@|           |     |####                                           |
                      |     |####                                           |
             @@@@@@   |     |####          ####            #   #            |
                      |     |####          ####          ###   ###          |
                             ####          ####        #####   #####       S|
              ###  ################    ########      #######   #######     S|
#################  #########################################################|