                                                                     
          |                                                                      |
          |                                                                      |
       0  |                                                                      |
@@@@@     |                                                                      |
          |                                                                      |
          |           |     |####                                                |
    @@@@@@|           |     |####                                                |
                      |     |####                                                |
             @@@@@@   |     |####          ####            ###     ##            |
     @                |     |####          ####          #####     ####          |
                             ####          ####        #######     ######       S|
              ###  ################    ########      ######################     S|
#################  ##############################################################|