                                                                     
          |                                                         |
          |                                                         |
       0  |                                                         |
          |                                                         |
          |           |     |####                                   |
    @@@@@@|           |     |####                                   |
                      |     |####                                   |
@@@@@                 |     |####                                   |
             @@@@@@   |     |####          ####                     |
                      |     |####          ####         |     ###   |
                             ####          ####         |     ###  S|
              ###  ################    ########               ###  S|
#################  #################################################|