




                                                                                                                                         S
                                                                                                                                         S
                                                                                                                                     #######
                                                                                 @@@                                                 #######
        #                                                                                                                            #######
        ##                                                                  @@@@                                ######               #######
  0     #########          ####                                                                                              ######               #######
                                                                                                                ######               #######
#####################################                                                                                      ######    ######               #######