




                                                                                                                                           S
                                                 #########  ##                                                                             S
                                              ######  ####  #####                                                                     #######
                                            ######          ########                    @@@                                           #######
        #                              ######   #    ##############                                                                   #######
        ##                       ###########        #############            @@@@                                ######               #######
  0     #########           ###############   #########################                                          ######               #######
                                                                  #####                                          ######               #######
#######################################################################                                ######    ######               #######